F 220,111,   250  

  C        225  , 70                           ,  252

11110110111111111000000100011

         NO                             ./test-north.xpm 
   SO   ./test-south.xpwqem    

            WE ./test-west.xpm  
EA ./test-east.xpm 






11111111111111111111111111111
11110110111111111000000100011
11100111111111011101010010001
11000000110101011101000001001
10000000000000011010000100001
10000010000000011010100100011
11000001110101001111011110101
10110111111010011111110100011
11111111111111111111111111111