  C        225 , 70                           ,  252


         NO                             ./test-north.xpm 
        SO  ./test-south.xpwqem    

            WE ./test-west.xpm  
EA ./test-east.xpm 


  F       225 , 70                           ,  251



11111111111111111111111111111
11110110111111111000000100001
11100111111111011101010010001
110000001101010111010000010001
100000000000S00110100001000001
10000010000000011010100100011
11000001110101001111011110101
1111011111101001111111010001
1111111111111111111111111111

