F 220,111,   250  

  C        225  , 70                           ,  252


         NO                             ./test-north.xpm 
   SO  ./test-south.xpwqem    

            WE ./test-west.xpm  
EA ./test-east.xpm 





11111111111111111111111111111
