NO ./images/gold_wood.xpm
SO ./images/wall2.xpm
WE ./images/terra2.xpm
EA ./images/corinthians2.xpm

F 51,51,51
C 170,170,255





11111111111111111111
100000000000000000011
111111111101111111001
100000001000000010001111
1111011110111101111011111
100001000000000100001
101101011111110101101
100001010000010100001
111101010111010111101
100001000000000000001
101101011011111011101
100001000000000000001
111101110111011111101
10000000N000000000001
111111111111111111111
