NO  ./textures/test-north.xpm
SO ./textures/test-south.xpm
WE ./textures/test-weast.xpm
EA ./textures/test-east.xpm

F 220,100,0
C 225,30,0

111111111111111
100001000000001
100001000000001
100111000000001
10000000N000001
100010001011111
100010001000001
111111111111111
